#*...`#......#.....*...........`.#...*`..#.....#..`*...*.....#......#.`.*...`..#....*..#.`...#....`....#......*...`...#......#..*..#
.#..``..#..`..``..`.`.....*...```....``.`..`#.*.`.``.#..`.`....*..``.```.#`.`..`#....`...`..`.#..```..`.#...`..`#.`.`....`..*..`..#.
#`.``"``..```.``"`````...`.```"```.``````."``..`````..."```.``...`"`````".`"``"`..`"```.``"``..`"```````...``"```.``"`..`"``..```.`#
`#"```````````````"````````````````"`````````````"`````````"``````````"`````````"``````````````````"``````"````````````"```````"``#`
...````"````````````"````````````````````````"`````````````````````````````````````````"````````````````````````````"````````````.."
`.``"`````"`````````````````"```````"````````````````````"````````````````"```````````````"``````````"`````````"````````````"`````.`
[[[[[[[[[[[[[[[[[[[[[[[[[[[[[[[[[[[[[[[[[[[[[[[[[[[[[[[[[[[[[[[[[[[[[[[[[[[[[[[[[[[[[[[[[[[[[[[[[[[[[[[[[[[[[[[[[[[[[[[[[[[[[[[[[[[[
====================================================================================================================================
]]]]]]]]]]]]]]]]]]]]]]]]]]]]]]]]]]]]]]]]]]]]]]]]]]]]]]]]]]]]]]]]]]]]]]]]]]]]]]]]]]]]]]]]]]]]]]]]]]]]]]]]]]]]]]]]]]]]]]]]]]]]]]]]]]]]
#``````"````````````"````````````````````````"``````````..#`.#`"``.````````````````````"````````````````````````````"``````````````#
`#"```````"`````````````````"```````"````````````````````"`.``#.`#````````"`````````"`````"``"```````"``````"```````````````"`````#`
#`````````````````"````````````````"`````````````"````````.`#`.#`..```"`````````"``````````````````"`````````````"`````````````"```#
.#.``#`.```.`.```.`"`.`%````#`.`.`````.```."``.``..#.`.```#"`#..`".`.``#...`.``````````"```````````````"````````"````````#.``.#`.`#`
#..#"`........#``..`..`..``..`....``...."`.`.`.........`...`...#.``#..`...#..`"```````````````````"```````````````````".`...`...."`#
.#..`.....@........#....................`..`..#..............#........#.......`````"```````````````````````````````````...#....#.`#.
#.#........................#.#.#..............................#.....#.........``````````````````"``````````````````...#......#.....#
.#...................x......#.........#............#......#..#.#...........````````````````````````````````"```````.#.............#.
#........................#.#..................................#........#..````````````````"`````````````````````````.....#.....#...#
.#..#.....................#..............#..............#..#.#....#........`````"````````````````````````````"````.#..............#.
#..#..#.#....#...........................................................````````````````````````````"``````````````...............#
.#.#.#.#...........................M.......................................`````````````````W``````````````````````...............#.
#.#.#.#.#........................&..........................................`````````"```````````````````````"```````..............#
.#...#.#.#..&..............................................................```"````````````````"```````````````````...............#.
#..#.#.#............................#.#.#.....#.............#.....#...........```````````````````````````"```````..............#...#
.#..#...#......#.................#...#.#.....................#..#......#.```````````````"``````````````````````````...............#.
#.#...#..#.#..#..#.#..................#........#...........#..#....#......``"````````````````````````"```````````....#.............#
.#..#....#..#...#.........................................#.#.#.#.....#.`````````````"`````````"``````````````...........#.....#..#.
#..#..#...#..#.#...............#.........................#.#.#...#..#....```````"```````````````````````"``````#.............#...#.#
.#......#...............#...............................#.....#......#`````"```````````````````"```````````#...........#...#....#.#.
#..........#...............................................#....#.#......````#.``#.`.````````````#....``........#...#....#..#..#...#
.#...............#...........................................#.....#.....#``....`..#....``....`.....#.`....#...#......#.#....#....#.
#.................#............................................#..#..#..#.#`.#.#..#...#.#...#.#.#..#..#...#..#....#.......#........#
.#..............................................................#...#..#...........#.....#...#...#..#...#...#....#....#...........#.
#..................................................................#........#...............#...#.#................................#
.#................................................................................................................................#.
#..................................................................................................................................#
.#................................................................................................................................#.
#..................................................................................................................................#
.#................................................................................................................................#.
#..................................................................................................................................#
.#................................................................................................................................#.
#..................................................................................................................................#
.#................................................................................................................................#.
#..................................................................................................................................#
.#................................................................................................................................#.
#..................................................................................................................................#
.#................................................................................................................................#.
#..................................................................................................................................#
.#................................................................................................................................#.
#....`.........................`......`...........`...................`.....`............`........`...............`................#
.#..``.....`..``..`.`.........```....``.`..``...`.``....`.`.......``.```..`.`..`.....`...`..`....```..`.....`..`..`.`....`.....`..#`
#`.``"``..```.``"`````...`.```"```.``````."``..`````..."```.``...`"`````".`"``"`..`"```.``"``..`"```````...``"```.``"`..`"``..```.`#
`#``"`````"`````````````````"```````"````````````````````"````````````````"```````````````"``````````"`````````"````````````"`````#`
.``````"````````````"````````````````````````"`````````````````````````````````````````"````````````````````````````"``````````````.
``"```````````````"````````````````"`````````````"`````````"``````````"`````````"``````````````````"``````"````````````"```````"```
[[[[[[[[[[[[[[[[[[[[[[[[[[[[[[[[[[[[[[[[[[[[[[[[[[[[[[[[[[[[[[[[[[[[[[[[[[[[[[[[[[[[[[[[[[[[[[[[[[[[[[[[[[[[[[[[[[[[[[[[[[[[[[[[[[[[
====================================================================================================================================
====================================================================================================================================
====================================================================================================================================
]]]]]]]]]]]]]]]]]]]]]]]]]]]]]]]]]]]]]]]]]]]]]]]]]]]]]]]]]]]]]]]]]]]]]]]]]]]]]]]]]]]]]]]]]]]]]]]]]]]]]]]]]]]]]]]]]]]]]]]]]]]]]]]]]]]]
```````"````````````"````````````````````````"`````````````````"```````````````````````"````````````````````````````"```````````````
``"```````"`````````````````"```````"````````````````````"````````````````"`````````"`````"``"```````"``````"```````````````"```````
``````````````````"````````````````"`````````````"````````````````````"`````````"``````````````````"`````````````"`````````````"````
...``.`.```.`.```.`"`.`.````.`.`.`````.```."``.``....`.```."`...`"``.``....`.````.....`"`.`...``..``..`"``..`.``"`...````..``..`.`"`
...."`.........``..`..`..``..`....``...."`.`.`.........`...`.....``...`......`"`.......`.........`"`...``..`...```...`".`...`...."`.
....`...................................`..`..................................`...................`...................`..........`..